
NO ./path_to_the_north_texture
WE ./path_to_the_west_texture
C 225,20,18
SO ./path_to_the_south_texture
F 220,100,0
EA ./path_to_the_east_texture



     

        1111111111111111111111111
        1000000000110000000000001
        1011000001110000000000001
        1001000000000000000000001
111111111011000001110000000000001
100000000011000001110111111111111
11110111111111111100000010001
11110111111111 11101010010001
11000000110101111100000010001
10000000000000001100000010001
10000000000000001101010010001
11000001110101011111011110N01
11110111 11101011111110100011
11111111 1111111 111111111111