
NO ./path_to_the_north_texture
WE ./path_to_the_west_texture
SO ./path_to_the_south_texture
EA ./path_to_the_east_texture

C 225,20,18
F 220,100,0

11111111
10000001
10000001
11110001
10000001
100N0001
10000001
11111111