
NO ./path_to_the_north_texture
WE ./path_to_the_west_texture
C 225,20,18
SO ./path_to_the_south_texture
F 220,100,0
EA ./path_to_the_east_texture



     
111 111 11111111111111111
1 11101111110000000000001
110100000000000000000000100000001
111111111011000001110000000000001
100000000011000001110111111111111
11110111111111011100000010001
11110111111111011101010010001
110000001101N1011100000010001
10000000000111001100000010001
10000000000000001101010010001
11000001110101011111011110N0111
11110111 1110101 101111010001
11111111 1111111 111111111111